WWWWWWWWWW
W        W
W BBWBBW W
W B    B W
W B WW B W
W B B  W W
W B  B B W
W BWWW W W
W      B W
WWWWWWWWWW
