WWWWWWWWWW
W        W
W B BBBB W
W B    B W
WB BBB B W
WB B B B W
W  B   B W
WB BBBBB W
W        W
WWWWWWWWWW
